         ######################       
        ##     ...............##      
       ##      .               ##     
       ##      .      ......    ##    
      ##       .......          ###   
     ##   ......       #############  
   ###         .     ###           ## 
#####          .                    ##
#   #          .         ......      #
#   #           .    ###            ##
#   #            .     ############## 
#                 .                #  
#                 .                #  
#   #               .              #  
#   #               .              #  
#   #               .              #  
##  #               .             ##  
 ####            ######          ##   
    ##          ##    ##         #    
     #          #      #         #    
     #          #      #        ##    
     #         ##      ##      ##     
     ##       ##        ########      
      #########                       